NO  efwefwef


C 123,           				123,123
F 255, 	 	1, 	 0







SO ergergerg
EA egergerg











	 		 WE WE



	11111111111111111111111111111111111111111
100000000100000000000000000000000000000001
100000000100000000000000000000000000000001
100000000100000000000000000000000000000001
11111111110000000000000000000000000000001
100000000000000000000000000000000111111111
1000000000000000000000000000000001
100000000000			000000000111111111
100000000000000000000000000000000000000001
100000000000000000000N00000000000000000001
100000000000000000000000000000000000000001
100000000000000000000000000000000000000001
100000000000000000000000000000000011100001
10000000000000000000000000000000001 100001
11111111111111111111111111111111111 111111
