
NO ./textures/wall2.xpm
SO ./textures/wall2.xpm
WE ./textures/wall3.xpm
EA ./textures/wall2.xpm

F 	255,255,255
C 135,206,235

11111111
11011D11
1000DSD1
11111D11
11111111






