11111111111111
10000000000001
10000000000001
10000000000001
10000000000001
10000000000001
10000000000101
10000000001  1
10000000001  1
11111111111  1