NO ./textures/wall1.xpm
SO ./textures/wall2.xpm
F 66,66,66
WE ./textures/wall3.xpm

C 135,206,235
EA ./textures/wall4.xpm

            1111111111111111111111111
            1000000000110000000000001
     11 111110000011100000000000011111111
    100100000000000000000000111111111
    111111111011000001110000000000001
    100000000011000001110111111111111
    11110111111111011100000010001111
    111101111111111  11101010010001
    1100000011010101110000001000111
11111111000000000000001100000010001
10S0000D0000000010010100100011 111
1000000111010101110000100000111
10000001 1000001 100000010101
11111111 1111111 111111111111

