NO ./textures/old1.xpm
SO ./textures/old2.xpm
WE ./textures/wall_metal1.xpm

F 	255,255,21
C 135,206,0

EA ./textures/wall_metal2.xpm

11111111111111111111111
1NDDDDDDDDDDDDDDDDDDDD1
11111111111111111111111



