NO ./textures/wall1.xpm
SO ./textures/wall2.xpm
WE ./textures/wall_metal2.xpm
EA ./textures/wall_metal1.xpm

F 66,66,66
C 135,206,235

            1111111111111111111111111
            1000000000110000000000001
     11 111110000011100000000000011111111
    100100000000000000000000111111111
    111111111011000001110000000000001
    100000000011000001110111111111111
    11110111111111011100000010001111
    111101111111111  11101010010001
    1100000011010101110000001000111
11111110000000000000001100000010001
100000000000000011010100100011 111
11000001110101011111011110W0111
11110111 1110101 101111010101
11111111 1111111 111111111111