NO ./textures/wall3.xpm
SO ./textures/wall4.xpm
WE ./textures/wall1.xpm
EA ./textures/wall2.xpm

F 	255,255,21
C 135,206,0


11111111111111111111111
1111D111111111111111111
111DND11111111111111111
1111D111111111111111111
1111111111111111111111



