NO ./textures/wall1.xpm
SO ./textures/wall2.xpm
WE ./textures/wall3.xpm
EA ./textures/wall4.xpm

F 0,  0, 0

C 135,206, 255


111111
111111

11111111111111
11111111111
1N  	 1
1111111111111
1101
111


1111111
10000001
1111111

