NO ./textures/wall1.xpm
SO ./textures/wall2.xpm
WE ./textures/wall3.xpm
EA ./textures/wall4.xpm

F 255,255,21
C 135,206,0

1111111
101
1111111

11111111111111111111111
1111000000000000000000011
1110N00000000000000000001 
111100000000000000000011
1111111111111111111111