NO ./textures/wall1.xpm
SO ./textures/wall2.xpm
WE ./textures/wall3.xpm
EA ./textures/wall4.xpm

F 0,  0, 0             

C 135,206, 255





111111
111
1N1111
1101
111


