NO ./textures/wall1.xpm
SO ./textures/wall2.xpm
WE ./textures/wall_metal2.xpm
EA ./textures/wall_metal1.xpm


C 123,123,123
F 255,1,0




11111111111111111111111
10000000000000000000001
10000000000000000000001
10000000000000000000001
10000000000000000000001
10000000000000000N00001
10000000000000000000001
10010000000000000011111
101 10000000000001
111 1111111111111111111
