NO ./textures/wall1.xpm
SO ./textures/wall2.xpm
WE ./textures/wall_metal2.xpm
EA ./textures/wall_metal1.xpm


C 123,123,123
F 255,1,0















                   1                                                   1
                  101                                                 101
                 10001                                               10001
                1000001                                             1000001
               100000001                                           100000001
              10000000001                                         10000000001
             1000000000001                                       1000000000001
            100000000000001                                     100000000000001
           10000000000000001                                   10000000000000001
          1000000000000000001              111111111111       1000000000000000001
         100000000000000000001             100000000001      100000000000000000001
        10000000000000000000001            101111111101     10000000000000000000001
       1000000000000000000000001     111111101    10001    1000000000000000000000001
      100000000000000000000000001    100001101    1011    100000000000000000000000001
     10000000000000000000000000001   101100001   1001    10000000000000000000000000001
    1000000000000000000000000000001  101 1111   1001    1000000000000000000000000000001
   100000000000000111111110000000001 101        101    100000000000000111111110000000001
  1000000000000001        10000000001101        101   1000000000000001        10000000001
 1000000000000001          1000000000101        101111000000000000001          10000000001
1000000000000001            10000000N001        100000000000000000001           1000000001
 1000000000000001            10000000011        111111000000000000001            1000000001
  1000000000000001            10000001                1000000000000001            10000001
   10000000000000011111111    1000001                  10000000000000011111111    1000001
    10000000000000000000001    11111                    10000000000000000000001    11111
     100000000000000000000011  1                         100000000000000000000011  1
      10000000000000000000001  1                          10000000000000000000001  1
       1000000000000000000001  1                           1000000000000000000001  1
        100000000000000000001  1                            100000000000000000001 1
         1000000000000000001   1                             1000000000000000001   1
          10000000000000001   1                               10000000000000001   1
           100000000000001    1                                100000000000001    1
            1000000000001    1                                  1000000000001    1
             10000000001    1                                    10000000001    1
              100000001    1                                      100000001    1
               1000001                                             1000001
                10001                                               10001 
                 101                                                 111 
                  1                                                   1