NO ./textures/wall1.xpm
SO ./textures/wall2.xpm
WE ./textures/wall3.xpm
EA ./textures/wall4.xpm

C 123,1,22
F 255,220,222

111111
1111111111
100001 
1N11111111
111111
101111
111111









