NO ./textures/wall1.xpm
SO ./textures/wall2.xpm
WE ./textures/wall3.xpm
EA ./textures/wall4.xpm

C 123,100,22
F 255,220,222

111111
1111111111
100001
1N00011111
10101
100111
111111
